{
  "00": "MA",
  "01": "MA",
  "02": "MA",
  "03": "MA",
  "04": "MA",
  "05": "MA",
  "06": "CT",
  "07": "NJ",
  "08": "NJ",
  "09": "CT",
  "10": "DE",
  "11": "NY",
  "12": "NY",
  "13": "NY",
  "14": "NY",
  "15": "PA",
  "16": "PA",
  "17": "PA",
  "18": "PA",
  "19": "PA",
  "20": "MD",
  "21": "MD",
  "22": "VA",
  "23": "VA",
  "24": "MD",
  "25": "DC",
  "26": "SC",
  "27": "NC",
  "28": "NC",
  "29": "SC",
  "30": "GA",
  "31": "AL",
  "32": "FL",
  "33": "FL",
  "34": "FL",
  "35": "AL",
  "36": "AL",
  "37": "TN",
  "38": "MS",
  "39": "MS",
  "40": "KY",
  "41": "IN",
  "42": "OH",
  "43": "KY",
  "44": "MO",
  "45": "IN",
  "46": "MI",
  "47": "MI",
  "48": "OH",
  "49": "OH",
  "50": "IA",
  "51": "IA",
  "52": "ND",
  "53": "WA",
  "54": "SD",
  "55": "WI",
  "56": "MT",
  "57": "MN",
  "58": "ND",
  "59": "SD",
  "60": "IL",
  "61": "IL",
  "62": "IL",
  "63": "MO",
  "64": "MO",
  "65": "KS",
  "66": "KS",
  "67": "NE",
  "68": "NE",
  "69": "NE",
  "70": "NJ",
  "71": "AR",
  "72": "LA",
  "73": "NJ",
  "74": "OK",
  "75": "TX",
  "76": "TX",
  "77": "TX",
  "78": "TX",
  "79": "TX",
  "80": "CO",
  "81": "CO",
  "82": "NM",
  "83": "ID",
  "84": "UT",
  "85": "AZ",
  "86": "AZ",
  "87": "NM",
  "88": "NV",
  "89": "UT",
  "90": "CA",
  "91": "CA",
  "92": "CA",
  "93": "CA",
  "94": "CA",
  "95": "CA",
  "96": "OR",
  "97": "OR",
  "98": "WA",
  "99": "WA",
  "336": "FL",
  "606": "IL",
  "733": "TX",
  "850": "AZ",
  "902": "CA"
}