{
  "32": "FL",
  "33": "FL",
  "34": "FL",
  "90": "CA",
  "91": "CA",
  "92": "CA",
  "93": "CA",
  "94": "CA",
  "95": "CA",
  "75": "TX",
  "76": "TX",
  "77": "TX",
  "78": "TX",
  "79": "TX",
  "80": "CO",
  "81": "CO",
  "73": "NJ",
  "08": "NJ",
  "07": "NJ"
}